+-------------+
|.............|
|.............|
|.............|
|.............|
|.............|
|.............|
|.....+-......|
|.....|.......|
|.............|
|.............|
|.............|
|.............|
|.............|
|.............|
|.............|
|.............|
|.............|
|.............|
|.............|
|.............|
|.............|
|.............|
|.............|
|.............|
|.............|
|.............|
|.............|
|.............|
|.............|
|.............|
|.............|
|.............|
|.............|
|.............|
|.............|
|.............|
+-------------+
