 +------+   +--+   +--+ +---------+ +--------+  +---------+ +---------+ +---------+
 |......|   |..|   |..| |.........| |........|  |.........| |.........| |.........|
 |......+-+ |..|   |..###..+---+..###..+-----+  |..+------+ |..+---+..| |..+---+..|
 |.+--+...| |..|   |..| |..|   |..| |..|        |..|        |..|   |..| |..|   |..|
 |.|  |...| |..|   |..| |..|   |..| |..|   +--+ |..##########..|   |..| |..|   |..|
 |.|  |...###..+---+..| |..|   |..| |..|   |..| |..|        |..|   |..| |..|   |..|
 |.+--+...| |.........| |..|   |..| |..+---+..###..+------+ |..+---+..###..|   |..|
 |........| |.........| |..|   |..| |.........| |.........| |.........| |..|   |..|
 +--------+ +---------+ +--+   +--+ +---------+ +---------+ +---------+ +--+   +--+
